...........
...........
...........
...........
.sssssssss.
.s.......s.
.s.sssss.s.
.s.s...s.s.
.s.s.s.s.s.
.s.s...s.s.
.s.sssss.s.
.s.......s.
.sssssssss.
