...........
...........
.....s.....
...bbsgg...
..bbwwwgg..
.bbwwwwwgg.
.bbwwwwwgg.
.bbwwwwwgg.
.s.s.s.s.s.
.....s.....
.....s.....
...G.G.....
...GGG.....
....G......



