...........
...........
ggggggggggg
...........
wwwGGGGGGGG
...........
rrrrrrrrrrr
...........
GGGGGGGGwww
...........
ppppppppppp
...........
bbbGGGGGGGG
...........
bbbbbbbbbbb
...........
GGGGGGGGbbb