.G.........
...........
.G.........
.G.........
.G....b....
.G...bcb...
.G..bcbcb..
.G.bcbsbcb.
.G..bcbcb..
.G...bcb...
.G....b....
.G.........
.G.........
.G.........
.G.........
.GGGGGGGGGG


