...........
...........
...........
bbbbbbbbbbb
bGGGpGpGGGb
bG.......Gb
bGp.....pGb
bGpp...ppGb
.bGpp.ppGb.
..bGpppGb..
...bGpGb...
....bpb....
.....b.....