...........
...........
...........
.GoooooooG.
.G.......G.
.G.GGGGG.G.
.G.GbbbG.G.
.G.GpppG.G.
.G.GgggG.G.
.G.GoooG.G.
.G.GcccG.G.
.G.......G.
.G.......G.
.GGGGGGGGG.



