...........
...........
...........
rrrrrrrrrrr
ggggggggggg
bbbbbbbbbbb
GGGGrrrGGGG
GggGsssGggG
GrrG...GbbG
G.........G
G.........G
G.........G
G..GgggG..G
GssGGGGGssG
