...........
...........
.....G.....
...ww.ww...
.ww..G..ww.
w..yy.yy..w
.yy..G..yy.
y..gg.gg..y
.gg..G..gg.
g..rr.rr..g
.rr..G..rr.
r..bb.bb..r
.bb..G..bb.
b..gg.gg..b
.gg.....gg.
g.........g



