...........
...........
...........
...........
..GssG.....
.G....G....
G..cc..G...
G.bbbb.G...
G..pp..G...
.G....G....
..GGGG.....