...........
...........
...........
o.GyyyyyG.o
o.GGyyyGG.o
o.G.GoG.G.o
o.G.gsg.G.o
o.G.g.g.G.o
o.G.g.g.G.o
o.G.g.g.G.o
o.G.g.g.G.o
o.G.g.g.G.o
oGGGg.gGGGo




