...........
...........
GGGGGGGGGGG
....G...Gy.
.Gg.G...G..
.G..G.G.G..
.G..GgG.G..
.G.yG.GbG..
.G..GrG.G..
.G..G.G.G..
.Gc...G....
.G....G...y
.GGGGGGGGGG
