...........
...........
...........
..G.G.G.G..
..G.G.G.G..
..G.G.G.G..
..G.G.Grr..
..G.G.G.G..
..G.Gbbbb..
..G.G.G.G..
..Grrrrrr..
..G.G.G.G..
..yyyyyyy..
..sssssss..